Aalsmeer NH	Aalsmeer
Aalst BeLb	Aalst
Aalst BeOv	Aalst
Aalten Gl	Aalten
Aardenburg Ze	Aardenburg
Aarlanderveen ZH	Aarlanderveen
Aarschot BeBr	Aarschot
Abbekerk NH	Abbekerk
Achterberg Ut	Achterberg
Aduard Gn	Aduard
Afferden Lb	Afferden
Akkrum Fr	Akkrum
Almen Gl	Almen
Almkerk NB	Almkerk
Alphen NB	Alphen
Alsemberg BeBr	Alsemberg
Ameide ZH	Ameide
Amersfoort Ut	Amersfoort
Angerlo Gl	Angerlo
Anjum Fr - Eanjum Fr	Anjum
Anloo Dr	Anloo
Antwerpen BeAnt	Antwerpen
Apeldoorn Gl	Apeldoorn
Appelscha Fr - Appelskea Fr	Appelscha
Appingedam Gn	Appingedam
Arendonk BeAnt	Arendonk
Arnemuiden Ze	Arnemuiden
Arum Fr	Arum
Asse BeBr	Asse
Assenede BeOv	Assenede
Austerlitz Ut	Austerlitz
Avelgem BeWv	Avelgem
Axel Ze	Axel
Baardegem BeOv	Baardegem
Baarle-Nassau NB	Baarle-Nassau
Bakel NB	Bakel
Bakkeveen Fr - Bakkefean Fr	Bakkeveen
Balen BeAnt	Balen
Balkbrug Ov	Balkbrug
Barger-Oosterveld Dr	Barger-Oosterveld
Barneveld Gl	Barneveld
Bathmen Ov	Bathmen
Beek NB	Beek
Beetgumermolen Fr - Bitgummole Fr	Beetgumermolen
Bellegem BeWv	Bellegem
Benschop Ut	Benschop
Bergen op Zoom NB	Bergen op Zoom
Bergentheim Ov	Bergentheim
Beringen BeLb	Beringen
Berkel-Oud ZH	Berkel-Oud
Beveren BeOv	Beveren
Bilzen BeLb	Bilzen
Blankenberge BeWv	Blankenberge
Bleskensgraaf ZH	Bleskensgraaf
Blokzijl Ov	Blokzijl
Boekel NB	Boekel
Bollezeele FrVl - Bollezele FrVl	Bollezeele
Bolsward Fr - Boalsert Fr	Bolsward
Booischot BeAnt	Booischot
Boom BeAnt	Boom
Borculo Gl	Borculo
Borgloon BeLb	Borgloon
Borne Ov	Borne
Bornem BeAnt	Bornem
Boutersem BeBr	Boutersem
Boven-Hardinxveld ZH	Boven-Hardinxveld
Boxtel NB	Boxtel
Breda NB	Breda
Bredevoort Gl	Bredevoort
Bree BeLb	Bree
Breskens Ze	Breskens
Brielle ZH	Brielle
Brouckerque FrVl - Broekkerke FrVl	Brouckerque
Brugge BeWv	Brugge
Brummen Gl	Brummen
Budel NB	Budel
Buggenhout BeOv	Buggenhout
Burcht BeAnt	Burcht
Buren Fr - Bueren Fr	Buren
Burum Fr - Boerum Fr	Burum
Buurmalsen Gl	Buurmalsen
Bellingwolde Gn	Bellingwolde
Blanden BeBr	Blanden
Borkel NB	Borkel
Brouwershaven Ze	Brouwershaven
Brunssum Lb	Brunssum
Callantsoog NH	Callantsoog
Coevorden Dr	Coevorden
Culemborg Gl	Culemborg
Dalfsen Ov	Dalfsen
De Lier ZH	De Lier
De Lutte Ov	De Lutte
De Rijp NH	De Rijp
Dedemsvaart Ov	Dedemsvaart
Deerlijk BeWv	Deerlijk
Deil Gl	Deil
Delden Ov	Delden
Delft ZH hoog	Delft ZH
Delft ZH laag	Delft ZH
Den Dungen NB	Den Dungen
Den Ham Ov	Den Ham
Den Hoorn NH	Den Hoorn
Den Oever NH	Den Oever
Denderleeuw BeOv	Denderleeuw
Dendermonde BeOv	Dendermonde
Denderwindeke BeOv	Denderwindeke
Deurne NB	Deurne
Deventer Ov	Deventer
Didam Gl	Didam
Diemen NH	Diemen
Diepenbeek BeLb	Diepenbeek
Diepenveen Ov	Diepenveen
Dieren Gl	Dieren
Diest BeBr	Diest
Dodewaard Gl	Dodewaard
Doel BeOv	Doel
Doesburg Gl	Doesburg
Doetinchem Gl	Doetinchem
Dokkum Fr	Dokkum
Dongen NB	Dongen
Doornspijk Gl	Doornspijk
Driebruggen ZH	Driebruggen
Druten Gl	Druten
Dwingeloo Dr	Dwingeloo
Echt Lb	Echt
Echten Fr - Ychten Fr	Echten
Edam NH	Edam
Ede Gl	Ede
Eede Ze	Eede
Eeklo BeOv	Eeklo
Eelde Dr	Eelde
Eenrum Gn	Eenrum
Eexterveen Dr	Eexterveen
Egmond aan Zee NH	Egmond aan Zee
Egmond-Binnen NH	Egmond-Binnen
Eibergen Gl	Eibergen
Eijsden Lb	Eijsden
Eindhoven NB	Eindhoven
Elburg Gl	Elburg
Enkhuizen NH	Enkhuizen
Epen Lb	Epen
Essen BeAnt	Essen
Evergem BeOv	Evergem
Fijnaart NB	Fijnaart
Finsterwolde Gn	Finsterwolde
Formerum Fr - Formearum Fr	Formerum
Franeker Fr - Frjentsjer Fr	Franeker
Galmaarden BeBr	Galmaarden
Garderen Gl	Garderen
Gasselte Dr	Gasselte
Geel BeAnt	Geel
Geldrop NB	Geldrop
Genemuiden Ov	Genemuiden
Genk BeLb	Genk
Gent BeOv	Gent
Geraardsbergen BeOv	Geraardsbergen
Gerwen NB	Gerwen
Gierle BeAnt	Gierle
Giesbeek Gl	Giesbeek
Giethoorn Ov	Giethoorn
Gijzegem BeOv	Gijzegem
Gistel BeWv	Gistel
Glabbeek BeBr	Glabbeek
Goes Ze	Goes
Goetsenhoven BeBr	Goetsenhoven
Goirle NB	Goirle
Gooik BeBr	Gooik
Gorssel Gl	Gorssel
Gouda ZH	Gouda
Gouderak ZH	Gouderak
Goudswaard ZH	Goudswaard
Grasheide BeAnt	Grasheide
Grave NB	Grave
Grijpskerk Gn	Grijpskerk
Grijpskerke Ze	Grijpskerke
Groenekan Ut	Groenekan
Groenlo Gl	Groenlo
Groesbeek Gl	Groesbeek
Gronsveld Lb	Gronsveld
Grote-Brogel BeLb	Grote-Brogel
Grouw Fr - Grou Fr	Grouw
Grubbenvorst Lb	Grubbenvorst
Gulpen Lb	Gulpen
Haacht BeBr	Haacht
Haaksbergen Ov	Haaksbergen
Haamstede Ze	Haamstede
Halle BeBr	Halle
Hallum Fr	Hallum
Hamont BeLb	Hamont
Haps NB	Haps
Hardenberg Ov	Hardenberg
Harderwijk Gl	Harderwijk
Harkema Opeinde Fr - De Harkema Fr	Harkema Opeinde
Harlingen Fr - Harns Fr	Harlingen
Hasselt BeLb	Hasselt
Hasselt Ov	Hasselt
Hattem Gl	Hattem
Havelte Dr	Havelte
Heerde Gl	Heerde
Heerewaarden Gl	Heerewaarden
Hei- en Boeicop ZH	Hei- en Boeicop
Heikruis BeBr	Heikruis
Heinkenszand Ze	Heinkenszand
Heino Ov	Heino
Helchteren BeLb	Helchteren
Heldergem BeOv	Heldergem
Hellendoorn Ov	Hellendoorn
Hellevoetsluis ZH	Hellevoetsluis
Helmond NB	Helmond
Hengelo Gl	Hengelo
Heppen BeLb	Heppen
Herentals BeAnt	Herentals
Herk-De-Stad BeLb	Herk-De-Stad
Herkingen ZH	Herkingen
Herselt BeAnt	Herselt
Heteren Gl	Heteren
Hierden Gl	Hierden
Hilvarenbeek NB	Hilvarenbeek
Hindeloopen Fr - Hylpen Fr	Hindeloopen
Hoboken BeAnt	Hoboken
Hoedekenskerke Ze	Hoedekenskerke
Hoenderloo Gl	Hoenderloo
Hoepertingen BeLb	Hoepertingen
Hoeselt BeLb	Hoeselt
Hoevenen BeAnt	Hoevenen
Hollandsche Veld Dr	Hollandsche Veld
Hollum Fr	Hollum
Holwerd Fr - Holwert Fr	Holwerd
Hondeghem FrVl - Hondegem FrVl	Hondeghem
Hooghalen Dr	Hooghalen
Hoonhorst Ov	Hoonhorst
Hoorn NH	Hoorn
Horn Lb	Horn
Houten Ut	Houten
Houthulst BeWv	Houthulst
Huijbergen NB	Huijbergen
Huizen NH	Huizen
Hulste BeWv	Hulste
Humbeek BeBr	Humbeek
Hunsel Lb	Hunsel
Ieper BeWv	Ieper
IJlst Fr - Drylts Fr	IJlst
IJmuiden NH	IJmuiden
IJsselmuiden Ov	IJsselmuiden
IJzendijke Ze	IJzendijke
Ingen Gl	Ingen
Itegem BeAnt	Itegem
Jeuk BeLb	Jeuk
Joure Fr - De Jouwer Fr	Joure
Jubbega Fr - Jobbegea Fr	Jubbega
Jutphaas Ut	Jutphaas
Kalken BeOv	Kalken
Kalmthout BeAnt	Kalmthout
Kamerik Ut	Kamerik
Kampen Ov	Kampen
Kamperhout BeBr	Kamperhout
Kantens Gn	Kantens
Kaster BeWv	Kaster
Katwijk aan Zee ZH	Katwijk aan Zee
Kaulille BeLb	Kaulille
Kedichem ZH	Kedichem
Kerkrade Lb	Kerkrade
Kermt BeLb	Kermt
Kessel NB	Kessel
Klaaswaal ZH	Klaaswaal
Kleit BeOv	Kleit
Kloosterzande Ze	Kloosterzande
Knokke BeWv	Knokke
Koedijk NH	Koedijk
Koekange Dr	Koekange
Koekelare BeWv	Koekelare
Koewacht Ze	Koewacht
Kortgene Ze	Kortgene
Kortrijk BeWv	Kortrijk
Koudekerk aan den Rijn ZH	Koudekerk aan den Rijn
Koudum Fr	Koudum
Kozen BeLb	Kozen
Kruiningen Ze	Kruiningen
Kuinre Ov	Kuinre
Lage Zwaluwe NB	Lage Zwaluwe
Laren Gl	Laren
Laren NH	Laren
Lauw BeLb	Lauw
Lede BeOv	Lede
Ledringhem FrVl - Ledringem FrVl	Ledringhem
Leende NB	Leende
Leermens Gn	Leermens
Leeuwarden Fr - Ljouwert Fr	Leeuwarden
Leisele BeWv	Leisele
Lekkerkerk ZH	Lekkerkerk
Lemele Ov	Lemele
Lemmer Fr - De Lemmer Fr	Lemmer
Lent Gl	Lent
Leuven BeBr	Leuven
Lichtenvoorde Gl	Lichtenvoorde
Lier BeAnt	Lier
Lies Fr	Lies
Lo BeWv	Lo
Lochem Gl	Lochem
Lochristie BeOv	Lochristie
Loenen Gl	Loenen
Loenen Ut	Loenen
Lokeren BeOv	Lokeren
Loksbergen BeLb	Loksbergen
Lommel BeLb	Lommel
Londerzeel BeBr	Londerzeel
Loon op Zand NB	Loon op Zand
Lot BeBr	Lot
Maasbree Lb	Maasbree
Maasmechelen BeLb	Maasmechelen
Maastricht Lb	Maastricht
Makkum Fr	Makkum
Marken NH	Marken
Marrum Fr - Mearum Fr	Marrum
Marum Gn	Marum
Mechelen BeAnt	Mechelen
Mechelen-Bovelingen BeLb	Mechelen-Bovelingen
Meer BeAnt	Meer
Meerbeek BeBr	Meerbeek
Meerhout BeAnt	Meerhout
Meerssen Lb	Meerssen
Meije ZH	Meije
Meijel Lb	Meijel
Meppel Dr	Meppel
Merchtem BeBr	Merchtem
Middelburg BeOv	Middelburg
Middelburg Ze	Middelburg
Middelharnis ZH	Middelharnis
Middelie NH	Middelie
Midsland Fr - Midslan Fr	Midsland
Midwolda Gn	Midwolda
Moerbeke BeOv	Moerbeke
Moerkerke BeWv	Moerkerke
Molenbeek BeBr	Molenbeek
Monnickendam NH	Monnickendam
Montenaken BeLb	Montenaken
Moorslede BeWv	Moorslede
Mortsel BeAnt	Mortsel
Mouscron Be	Mouscron
Munkzwalm BeOv	Munkzwalm
Mussel Gn	Mussel
Nazareth BeOv	Nazareth
Nederbrakel BeOv	Nederbrakel
Nederweert Lb	Nederweert
Neede Gl	Neede
Neeroeteren BeLb	Neeroeteren
Neerwinden BeBr	Neerwinden
Nevele BeOv	Nevele
Nieurlet FrVl - Nieuwerleet FrVl	Nieurlet
Nieuw-Schoonebeek Dr	Nieuw-Schoonebeek
Nieuwerkerken BeLb	Nieuwerkerken
Nieuwkerke BeWv	Nieuwkerke
Nieuwpoort BeWv	Nieuwpoort
Nij Beets Fr	Nij Beets
Nijeholtpade Fr	Nijeholtpade
Nijmegen Gl	Nijmegen
Nijverdal Ov	Nijverdal
Ninove BeOv	Ninove
Nistelrode NB	Nistelrode
Noordeloos ZH	Noordeloos
Noordwolde Fr	Noordwolde
Norg Dr	Norg
Nukerke BeOv	Nukerke
Nunspeet Gl	Nunspeet
Oelegem BeAnt	Oelegem
Oerle NB	Oerle
Oijen NB	Oijen
Oirschot NB	Oirschot
Oisterwijk NB	Oisterwijk
Oldemarkt Ov	Oldemarkt
Oldenzaal Ov	Oldenzaal
Onstwedde Gn	Onstwedde
Ooike BeOv	Ooike
Ooltgensplaat ZH	Ooltgensplaat
Oostende BeWv	Oostende
Oosterbeek Gl	Oosterbeek
Oosterend Fr - Aasterein Fr	Oosterend
Oosterland Ze	Oosterland
Oostkamp BeWv	Oostkamp
Ootmarsum Ov	Ootmarsum
Opglabbeek BeLb	Opglabbeek
Ophasselt BeOv	Ophasselt
Ophoven BeLb	Ophoven
Opperdoes NH	Opperdoes
Ordingen BeLb	Ordingen
Ospel Lb	Ospel
Ossendrecht NB	Ossendrecht
Otterlo Gl	Otterlo
Ottersum Lb	Ottersum
Oud-Charlois ZH	Oud-Charlois
Oud-Vossemeer Ze	Oud-Vossemeer
Ouddorp ZH	Ouddorp
Oude Pekela Gn	Oude Pekela
Oude-Tonge ZH prot	Oude-Tonge ZH
Oude-Tonge ZH rk	Oude-Tonge ZH
Oudega Fr - Aldegea Fr	Oudega
Oudemirdum Fr - Aldemardum Fr	Oudemirdum
Oudenaarde BeOv	Oudenaarde
Oudergem BeBr	Oudergem
Oudeschoot Fr - Aldskoat Fr	Oudeschoot
Oudewater Ut	Oudewater
Overijse BeBr	Overijse
Overpelt BeLb	Overpelt
Panningen Lb	Panningen
Papendrecht ZH	Papendrecht
Peer BeLb	Peer
Piershil ZH	Piershil
Poederoijen Gl	Poederoijen
Poperinge BeWv	Poperinge
Poppel BeAnt	Poppel
Posterholt Lb	Posterholt
Pulle BeAnt	Pulle
Putten Gl	Putten
Puttershoek ZH	Puttershoek
Raalte Ov	Raalte
Ransberg BeBr	Ransberg
Reek NB	Reek
Renkum Gl	Renkum
Reusel NB	Reusel
Reuver Lb	Reuver
Rhenen Ut	Rhenen
Rijkevoort NB	Rijkevoort
Rijkevorsel BeAnt	Rijkevorsel
Rijsbergen NB	Rijsbergen
Rijssen Ov	Rijssen
Rilland Ze	Rilland
Rinsumageest Fr - Rinsumageast Fr	Rinsumageest
Roderwolde Dr	Roderwolde
Roermond Lb	Roermond
Roeselare BeWv	Roeselare
Roggel Lb	Roggel
Ronse BeOv	Ronse
Roodeschool Gn	Roodeschool
Roosendaal NB	Roosendaal
Rossum Ov	Rossum
Roswinkel Dr	Roswinkel
Rotterdam ZH	Rotterdam
Rottevalle Fr - Rottefalle Fr	Rottevalle
Rouveen Ov	Rouveen
Rozendaal Gl	Rozendaal
Ruinen Dr	Ruinen
Ruurlo Gl	Ruurlo
s-Gravenvoeren BeLb	s-Gravenvoeren
s-Gravenwezel BeAnt	s-Gravenwezel
s-Heerenberg Gl	s-Heerenberg
s-Heerenbroek Ov	s-Heerenbroek
s-Herenelderen BeLb	s-Herenelderen
s-Hertogenbosch NB	s-Hertogenbosch
Schagen NH	Schagen
Scheemda Gn	Scheemda
Schelluinen ZH	Schelluinen
Scherpenzeel Fr	Scherpenzeel
Scheveningen ZH	Scheveningen
Schiermonnikoog Fr - Skiermantseach Fr	Schiermonnikoog
Schinnen Lb	Schinnen
Schoonebeek Dr	Schoonebeek
Schoonoord Dr	Schoonoord
Sellingen Gn	Sellingen
Serooskerke Ze	Serooskerke
Sevenum Lb	Sevenum
Sexbierum Fr - Seisbierrum Fr	Sexbierum
Silvolde Gl	Silvolde
Sint Annaparochie Fr - Sint Anne Fr	Sint Annaparochie
Sint Jansteen Ze	Sint Jansteen
Sint Maartensdijk Ze	Sint Maartensdijk
Sint-Annen Gn	Sint-Annen
Sint-Joris-Ten-Distel BeWv	Sint-Joris-Ten-Distel
Sint-Niklaas BeOv	Sint-Niklaas
Sint-Oedenrode NB	Sint-Oedenrode
Sittard Lb	Sittard
Slagharen Ov	Slagharen
Sliedrecht ZH	Sliedrecht
Slochteren Gn	Slochteren
Sloten Fr - Sleat Fr	Sloten
Smilde Dr	Smilde
Sneek Fr - Snits Fr	Sneek
Someren NB	Someren
Spakenburg Ut	Spakenburg
Spanbroek NH	Spanbroek
Spannum Fr	Spannum
Stadskanaal Gn	Stadskanaal
Stavoren Fr - Starum Fr	Stavoren
Steenbergen NB	Steenbergen
Steenderen Gl	Steenderen
Steendorp BeOv	Steendorp
Steene FrVl - Stene FrVl	Steene
Steenvoorde FrVl - Steenvoorde FrVl	Steenvoorde
Steenwijk Ov	Steenwijk
Stekene BeOv	Stekene
Stokkem BeLb	Stokkem
Stokkum Ov	Stokkum
Stolwijk ZH	Stolwijk
Stompwijk ZH	Stompwijk
Susteren Lb	Susteren
Tegelen Lb	Tegelen
Ter Apel Gn	Ter Apel
Tessenderlo BeLb	Tessenderlo
Teuge Gl	Teuge
Tiel Gl	Tiel
Tienen BeBr	Tienen
Tienray Lb	Tienray
Tietjerk Fr - Tytsjerk Fr	Tietjerk
Tilburg NB	Tilburg
Tilligte Ov	Tilligte
Tjalleberd Fr - Tsjalbert Fr	Tjalleberd
Tongeren BeLb	Tongeren
Tongerlo BeAnt	Tongerlo
Torhout BeWv	Torhout
Tubbergen Ov	Tubbergen
Turnhout BeAnt	Turnhout
Ulft Gl	Ulft
Urk Fl	Urk
Ursem NH	Ursem
Usselo Ov	Usselo
Utrecht Ut	Utrecht
Vaals Lb	Vaals
Vaassen Gl	Vaassen
Valthermond Dr	Valthermond
Varsseveld Gl	Varsseveld
Veendam Gn	Veendam
Veenendaal Ut	Veenendaal
Veenwouden Fr - Feanwalden Fr	Veenwouden
Veghel NB	Veghel
Velddriel Gl	Velddriel
Veldwezelt BeLb	Veldwezelt
Velm BeLb	Velm
Venlo Lb	Venlo
Vessem NB	Vessem
Veurne BeWv	Veurne
Vliermaalroot BeLb	Vliermaalroot
Vlijtingen BeLb	Vlijtingen
Vlissingen Ze	Vlissingen
Voerendaal Lb	Voerendaal
Volendam NH	Volendam
Vollenhove Ov	Vollenhove
Voorst Gl	Voorst
Voorthuizen Gl	Voorthuizen
Vorden Gl	Vorden
Vossem BeBr	Vossem
Vreeswijk Ut	Vreeswijk
Vriezenveen Ov	Vriezenveen
Waardenburg Gl	Waardenburg
Waarloos BeAnt	Waarloos
Wagenborgen Gn	Wagenborgen
Walshoutem BeBr	Walshoutem
Wanssum Lb	Wanssum
Wapse Dr	Wapse
Waregem BeWv	Waregem
Warhem FrVl - Warrem FrVl	Warhem
Wateringen ZH	Wateringen
Watervliet BeOv	Watervliet
Weidum Fr	Weidum
Wellen BeLb	Wellen
Wemmel BeBr	Wemmel
Werkhoven Ut	Werkhoven
Wervik BeWv	Wervik
West-Terschelling Fr - West-Skylge Fr	West-Terschelling
Westerbork Dr	Westerbork
Westergeest Fr - Westergeast Fr	Westergeest
Westkapelle Ze	Westkapelle
Westmalle BeAnt	Westmalle
Wetteren BeOv	Wetteren
Wierden Ov	Wierden
Wierum Fr	Wierum
Wijdenes NH	Wijdenes
Wijhe Ov	Wijhe
Wijk bij Duurstede Ut	Wijk bij Duurstede
Wijnjeterp Fr - Wynjewald Fr	Wijnjeterp
Willemstad NB	Willemstad
Wilp Gl	Wilp
Windesheim Ov	Windesheim
Wingene BeWv	Wingene
Winterswijk Gl	Winterswijk
Wissenkerke Ze	Wissenkerke
Witgoor BeAnt	Witgoor
Woesten BeWv	Woesten
Wolvega Fr	Wolvega
Workum Fr - Warkum Fr	Workum
Woudenberg Ut	Woudenberg
Woudsend Fr - Waldsein Fr	Woudsend
Wouw NB	Wouw
Wulverdinghe FrVl - Wulverdinge FrVl	Wulverdinghe
Wuustwezel BeAnt	Wuustwezel
Zaandijk NH	Zaandijk
Zalk Ov	Zalk
Zandvliet BeAnt	Zandvliet
Zandvoort NH	Zandvoort
Zeddam Gl	Zeddam
Zeeland NB	Zeeland
Zegveld Ut	Zegveld
Zele BeOv	Zele
Zelhem Gl	Zelhem
Zetten Gl	Zetten
Zevenaar Gl	Zevenaar
Zevenbergen NB	Zevenbergen
Zichen-Zussen-Bolder BeLb	Zichen-Zussen-Bolder
Zierikzee Ze	Zierikzee
Zieuwent Gl	Zieuwent
Zoetermeer ZH	Zoetermeer
Zolder BeLb	Zolder
Zomergem BeOv	Zomergem
Zoutkamp Gn	Zoutkamp
Zoutleeuw BeBr	Zoutleeuw
Zuid-Sleen Dr	Zuid-Sleen
Zuiddorpe Ze	Zuiddorpe
Zuidzande Ze	Zuidzande
Zundert NB	Zundert
Zutendaal BeLb	Zutendaal
Zutphen Gl	Zutphen
Zuydcoote FrVl - Zuidkote FrVl	Zuydcoote
Zwartsluis Ov	Zwartsluis
Zwinderen Dr	Zwinderen
Zwolle Ov	Zwolle